20
20
####################
#                  #
#                  #
#                  #
#                  #
#                  #
#      #########   #
#                  #
#                  #
#                  #
#                  #
#                  #
#                  #
#                  #
#                  #
#                  #
#                  #
#                  #
#                  #  
####################
